0000000000000000000000000000
0000000000000000000000000000
0000000000000000000000000000
0000000000000000000000000000
0+----+-----+00+-----+----+0
0|0000|00000|00|00000|0000|0
0p0000|00000|00|00000|0000p0
0|0000|00000|00|00000|0000|0
0+----+--+--+--+--+--+----+0
0|0000|00|00000000|00|0000|0
0|0000|00|00000000|00|0000|0
0+----+00+--+00+--+00+----+0
000000|00000|00|00000|000000
000000|00000|00|00000|000000
000000|00+--+--+--+00|000000
000000|00|00000000|00|000000
000000|00|01111110|00|000000
+-----+--+01111110+--+-----+
000000|00|01111110|00|000000
000000|00|00011000|00|000000
000000|00+--------+00|000000
000000|00|00000000|00|000000
000000|00|00000000|00|000000
0+----+--+--+00+--+--+----+0
0|0000|00000|00|00000|0000|0
0|0000|00000|00|00000|0000|0
0p-+00+--+--+--+--+--+00+-p0
000|00|00|00000000|00|00|000
000|00|00|00000000|00|00|000
0+-+--+00+--+00+--+00+--+-+0
0|0000000000|00|0000000000|0
0|0000000000|00|0000000000|0
0+----------+--+----------+0
0000000000000000000000000000
0000000000000000000000000000
0000000000000000000000000000